[
    {
        "in": { "x": 0, "y": 1 },
        "out": { "x": 8, "y": 9 },
        "data": [
            [0, 1, 0, 0, 0, 0, 0, 0, 0, 0],
            [0, 1, 0, 0, 0, 0, 1, 0, 0, 0],
            [0, 1, 0, 0, 0, 1, 1, 0, 0, 0],
            [0, 1, 0, 0, 0, 1, 0, 0, 0, 0],
            [0, 1, 1, 1, 1, 1, 0, 0, 0, 0],
            [0, 0, 1, 0, 0, 0, 0, 0, 1, 0],
            [0, 0, 1, 1, 1, 1, 1, 1, 1, 0],
            [0, 0, 1, 0, 0, 0, 0, 0, 0, 0],
            [0, 0, 1, 1, 1, 1, 1, 1, 1, 1],
            [0, 0, 0, 0, 0, 0, 0, 0, 0, 0]
        ]
    },
    {
        "in": { "x": 0, "y": 1 },
        "out": { "x": 8, "y": 9 },
        "data": [
            [0, 1, 0, 0, 0, 0, 0, 0, 0, 0],
            [0, 1, 0, 0, 0, 0, 3, 0, 0, 0],
            [0, 1, 0, 0, 0, 1, 1, 0, 0, 0],
            [0, 1, 0, 0, 0, 1, 0, 0, 0, 0],
            [0, 1, 1, 1, 1, 1, 0, 0, 0, 0],
            [0, 0, 2, 0, 0, 0, 0, 0, 1, 0],
            [0, 0, 1, 1, 1, 1, 1, 1, 1, 0],
            [0, 0, 1, 0, 0, 0, 0, 0, 0, 0],
            [0, 0, 1, 1, 1, 1, 1, 1, 1, 1],
            [0, 0, 0, 0, 0, 0, 0, 0, 0, 0]
        ]
    }
]
